18 18
100 100
4 10 10 10 10 10 10 10 10 10 10 10 10 10 10 10 10 5
8 1  2  1  1  1  1  1  1  1  1  1  1  1  1  1  1  9  
8 2  1  1  1  3  1  1  1  1  1  1  1  2  1  12 1  9 
8 2  1  1  1  1  1  2  2  2  2  2  1  1  12 12 1  9 
8 2  2  3  3  1  1  2  2  12 12 2  1  1  12 12 1  9 
8 1  1  3  3  1  1  1  2  12 12 2  1  2  12 1  1  9 
8 1  1  1  1  1  1  1  2  12 12 2  1  1  1  1  1  9 
8 1  1  1  12 1  1  2  1  1  1  2  1  1  1  1  1  9  
8 1  1  1  1  1  1  1  3  1  1  2  2  1  1  1  1  9  
8 1  1  1  1  1  3  3  3  1  1  1  1  1  1  1  1  9  
8 2  2  1  2  2  3  1  1  1  1  1  1  1  1  1  1  9  
8 1  1  1  2  2  3  1  1  1  1  3  1  1  1  1  1  9  
8 1  1  1  1  2  2  1  1  1  1  1  1  1  1  1  1  9 
8 1  1  1  1  1  1  1  1  1  1  1  1  1  1  1  1  9  
8 1  1  1  1  1  1  1  2  1  1  1  1  2  1  1  1  9  
8 1  1  1  1  1  1  1  2  1  1  1  1  1  1  1  1  9 
8 1  1  1  1  1  1  1  1  1  1  1  1  1  1  1  1  9 
7 11 11 11 11 11 11 11 11 11 11 11 11 11 11 11 11 6